짧다 – ngắn  
길다 – dài  
많다 – nhiều  
적다 – ít  
두껍다 – dày  
얇다 – mỏng  
무겁다 – nặng  
가볍다 – nhẹ  
화려하다 – sặc sỡ  
단순하다 – đơn giản  
편하다 – thoải mái  
불편하다 – không thoải mái  
귤 – quả quýt  
기능 – chức năng, kỹ năng  
기분 – khí thế, tâm trạng  
노트북 – máy tính xách tay  
누구나 – ai cũng thế, mọi người  
다양하다 – đa dạng  
단어 – từ  
디자인 – thiết kế  
만 – chỉ  
빠르다 – nhanh  
샤프 – bút chì kim  
설악산 – Seorak-san, núi Seorak  
쇼핑몰 – khu mua sắm, shopping mall  
쉽게 – một cách dễ dàng  
슈퍼 – siêu thị  
신다 – đi, mang (giày, dép)  
싱겁다 – nhạt, nhạt nhẽo  
싸다 – rẻ  
유행하다 – thời trang, thịnh hành  
제품 – sản phẩm  
카드 – card, thẻ (như thẻ tín dụng)  
튼튼하다 – chắc chắn  
팔다 – bán  
필요하다 – cần thiết  
한라산 – Halla-san, núi Halla  
할인점 – cửa hàng giảm giá  
핸드백 – túi xách tay  
